Cues	Outcomes
=_q_=_b_ow_t_word_aboutness	ness
v_q_=_b_=_l_word_achievability	ity
sh_=_n_n_q_l_word_additionality	ity
d_i_=_t_i_v_word_additivity	ity
s_q_=_b_=_l_word_addressability	ity
b_q_=_b_=_l_word_adsorbability	ity
z_or_p_t_i_v_word_adsorptivity	ity
l_a_=_st_i_k_word_aeroelasticity	ity
f_e_kt_l_q_s_word_affectlessness	ness
d_q_=_b_=_l_word_affordability	ity
fr_i_=_k_q_n_word_Africanity	ity
=_q_=_g_e_nst_word_againstness	ness
dzh_q_n_t_i_v_word_agentivity	ity
g_q_=_b_=_l_word_aggregability	ity
gr_e_=_s_i_v_word_aggressivity	ity
w_ur_=_th_y_=_word_airworthiness	ness
l_i_=_=_q_n_word_alienness	ness
dzh_e_=_n_i_k_word_allergenicity	ity
=_i_=_my_oo_n_word_alloimmunity	ity
dzh_i_=_k_=_l_word_alogicality	ity
z_q_=_b_=_l_word_analysability	ity
l_i_=_t_i_k_word_analyticity	ity
r_q_=_b_=_l_word_answerability	ity
r_i_=_=_q_l_word_arboreality	ity
=_=_=_=_a_r_bound_arity	ity
m_a_=_t_i_k_word_aromaticity	ity
=_ay_=_zh_q_n_word_Asianness	ness
=_a_z_s_u_tsh_phrase_as-suchness	ness
l_i_=_=_q_n_word_Australianness	ness
v_q_=_r_i_dzh_word_averageness	ness
w_ay_=_k_i_d_word_awakedness	ness
r_q_=_b_=_l_word_bearability	ity
b_i_=_y_o_nd_word_beyondness	ness
by_u_=_l_q_s_word_bibulosity	ity
d_q_=_b_=_l_word_biddability	ity
l_i_ng_gw_=_l_word_bilinguality	ity
m_oh_=_d_=_l_word_bimodality	ity
d_q_=_b_=_l_word_biodegradability	ity
l_e_k_tr_i_k_word_bioelectricity	ity
dzh_e_=_n_i_k_word_biogenicity	ity
t_oh_=_n_=_l_word_bitonality	ity
bl_oh_=_k_i_sh_word_blokeishness	ness
bl_ur_=_r_y_=_word_blurriness	ness
b_oh_=_g_q_s_word_bogusness	ness
th_q_=_b_=_l_word_breathability	ity
b_u_l_b_q_s_word_bulbosity	ity
k_a_=_t_y_=_word_cattiness	ness
fy_oo_=_g_=_l_word_centrifugality	ity
s_i_=_t_i_v_word_chemosensitivity	ity
kl_or_=_r_i_n_word_chlorinity	ity
kl_ah_s_l_q_s_word_classlessness	ness
kl_oh_=_n_=_l_word_clonality	ity
b_q_=_b_=_l_word_clubbableness	ness
d_q_=_b_=_l_word_codability	ity
g_q_=_b_=_l_word_colligability	ity
k_q_=_b_=_l_word_collocability	ity
b_q_=_t_i_v_word_combativity	ity
t_ay_=_t_i_v_word_commutativeness	ness
t_q_=_t_i_v_word_commutativity	ity
t_q_=_t_i_=_word_complementarity	ity
p_u_l_s_i_v_word_compulsiveness	ness
r_q_d_l_y_=_word_comradeliness	ness
m_q_=_b_=_l_word_confirmability	ity
l_q_=_b_=_l_word_congealability	ity
dzh_u_ngk_t_i_v_word_conjunctiveness	ness
t_q_=_b_=_l_word_connectibility	ity
m_i_=_n_q_s_word_conterminousness	ness
l_q_=_b_=_l_word_controllability	ity
k_or_=_n_y_=_word_corniness	ness
kr_a_=_k_i_d_word_crackedness	ness
w_ur_=_th_y_=_word_crashworthiness	ness
k_u_=_p_y_=_word_cuppiness	ness
t_o_k_s_i_k_word_cytotoxicity	ity
=_=_=_d_a_b_word_dabbity	ity
d_a_=_sh_i_ng_word_dashingness	ness
d_ay_=_t_i_d_word_datedness	ness
d_e_f_bl_eye_nd_word_deafblindness	ness
d_q_=_b_=_l_word_decidability	ity
m_ah_n_dr_i_ng_word_demandingness	ness
r_q_=_b_=_l_word_denumerability	ity
d_q_=_b_=_l_word_dependability	ity
pr_e_=_s_i_ng_word_depressingness	ness
str_u_k_t_i_v_word_destructivity	ity
=_q_=_b_=_l_word_deviability	ity
sh_iq_=_b_=_l_word_differentiability	ity
r_e_k_t_i_d_word_directedness	ness
sh_q_=_n_=_l_word_directionality	ity
r_e_k_t_i_v_word_directivity	ity
n_q_=_b_=_l_word_discriminability	ity
k_ur_=_s_i_v_word_discursivity	ity
p_ur_=_s_i_v_word_dispersivity	ity
t_q_=_b_=_l_word_distractability	ity
by_u_=_t_i_v_word_distributivity	ity
=_=_=_d_u_n_word_doneness	ness
d_oh_=_p_y_=_word_dopiness	ness
=_e_=_dzh_i_d_word_double-edgedness	ness
dr_ee_m_l_q_s_word_dreamlessness	ness
=_=_=_dr_eye_d_word_driedness	ness
v_q_=_b_=_l_word_driveability	ity
sh_q_=_n_=_l_word_dysfunctionality	ity
t_o_k_s_i_k_word_ecotoxicity	ity
ny_oo_=_tr_=_l_word_electroneutrality	ity
f_i_=_l_i_k_word_electrophilicity	ity
n_q_=_b_=_l_word_eliminability	ity
=_q_=_b_=_l_word_employability	ity
s_q_=_b_=_l_word_enforceability	ity
r_q_=_b_=_l_word_enumerability	ity
=_q_=_b_=_l_word_enviability	ity
s_o_=_d_i_k_word_episodicity	ity
b_q_=_b_=_l_word_equiprobability	ity
t_q_=_b_=_l_word_equitability	ity
p_ee_=_=_q_n_word_Europeanness	ness
v_q_=_b_=_l_word_evolvability	ity
s_eye_=_t_i_ng_word_excitingness	ness
k_l_oo_s_i_v_word_exclusivity	ity
d_q_=_b_=_l_word_expandability	ity
t_q_=_b_=_l_word_exploitability	ity
pr_e_=_s_i_v_word_expressivity	ity
zh_q_=_n_=_l_word_extensionality	ity
f_a_k_t_i_k_word_facticity	ity
ty_oo_=_=_q_l_word_factualness	ness
=_q_=_b_=_l_word_falsifiability	ity
f_a_n_s_y_=_word_fanciness	ness
g_q_=_b_=_l_word_fatigability	ity
l_e_k_tr_i_k_word_ferroelectricity	ity
r_q_=_b_=_l_word_filterability	ity
h_a_n_d_i_d_word_firsthandedness	ness
g_o_=_t_q_n_word_forgottenness	ness
fr_i_=_z_y_=_word_frizziness	ness
fr_u_n_t_=_l_word_frontality	ity
fr_ow_=_st_y_=_word_frowstiness	ness
fr_u_m_p_y_=_word_frumpiness	ness
k_q_=_b_=_l_word_fuckability	ity
g_a_=_b_y_=_word_gabbiness	ness
g_ee_=_k_y_=_word_geekiness	ness
g_ee_=_k_i_sh_word_geekishness	ness
z_q_=_b_=_l_word_generalizability	ity
r_q_=_t_i_v_word_generativity	ity
n_e_=_r_i_k_word_genericity	ity
n_e_=_r_i_k_word_genericness	ness
g_ow_=_l_i_sh_word_ghoulishness	ness
gl_oh_=_b_=_l_word_globality	ity
g_oo_=_f_y_=_word_goofiness	ness
d_q_=_b_=_l_word_gradability	ity
d_q_=_b_=_l_word_gradeability	ity
gr_ay_=_n_y_=_word_graininess	ness
t_i_=_k_=_l_word_grammaticality	ity
d_q_=_b_=_l_word_grindability	ity
g_u_=_st_y_=_word_gustiness	ness
h_a_n_d_i_d_word_handedness	ness
l_q_=_b_=_l_word_handleability	ity
=_q_nd_f_ah_st_phrase_hard-and-fastness	ness
n_q_=_b_=_l_word_hardenability	ity
h_ee_=_l_i_k_bound_helicity	ity
m_q_=_t_i_v_word_heteronormativity	ity
t_i_=_b_=_l_word_histocompatibility	ity
=_=_=_h_ur_t_word_hurtness	ness
s_i_=_t_i_v_word_hypersensitivity	ity
t_o_=_n_i_k_word_hypotonicity	ity
k_o_=_n_i_k_word_iconicity	ity
=_a_k_t_i_v_word_immunoreactivity	ity
p_e_=_l_i_ng_word_impellingness	ness
t_i_=_k_=_l_word_impracticality	ity
s_e_n_d_i_v_word_incendivity	ity
kl_oo_=_s_i_v_word_inclusivity	ity
kw_e_n_sh_=_l_word_inconsequentialness	ness
n_q_=_b_=_l_word_indefinability	ity
s_q_=_b_=_l_word_inducibility	ity
k_q_=_b_=_l_word_ineducability	ity
i_i_=_k_=_l_word_inepticality	ity
r_i_=_b_=_l_word_inferrability	ity
m_q_=_t_i_v_word_informativeness	ness
=_i_t_s_e_lf_phrase_in-itselfness	ness
s_eye_d_=_ow_t_phrase_inside-outness	ness
zh_q_=_n_=_l_word_intensionality	ity
n_e_k_t_i_d_word_interconnectedness	ness
l_q_=_b_=_l_word_interpolability	ity
t_q_=_t_i_v_word_interpretativeness	ness
sy_oo_=_=_=_l_word_intersexuality	ity
s_q_=_b_=_l_word_intransmissibility	ity
v_ay_=_z_i_v_word_invasiveness	ness
=_o_=_n_i_k_word_ionicity	ity
sh_q_=_n_=_l_word_irrotationality	ity
p_q_=_n_ee_z_word_Japaneseness	ness
dzh_o_b_l_q_s_word_joblessness	ness
k_i_ng_k_y_=_word_kinkiness	ness
t_q_=_n_i_sh_word_kittenishness	ness
kl_e_n_dy_oo_s_bound_klendusity	ity
n_o_=_t_i_d_word_knottedness	ness
l_ay_=_s_y_=_word_laciness	ness
l_ay_=_=_i_k_word_laicity	ity
n_q_=_b_=_l_word_learnability	ity
l_e_ft_w_q_d_word_leftwardness	ness
l_e_g_l_q_s_word_leglessness	ness
ky_oo_=_l_q_=_word_lenticularity	ity
m_i_=_n_=_l_word_liminality	ity
l_eye_=_m_y_=_word_liminess	ness
l_i_ng_k_i_d_word_linkedness	ness
d_q_=_b_=_l_word_loadability	ity
z_q_=_b_=_l_word_localizability	ity
l_o_=_g_y_=_word_logginess	ness
l_o_=_p_y_=_word_loppiness	ness
l_ur_=_k_i_ng_word_lurkingness	ness
n_q_=_b_=_l_word_machinability	ity
t_q_=_l_eye_n_word_macrocrystallinity	ity
n_q_=_b_=_l_word_maintainability	ity
m_or_l_t_y_=_word_maltiness	ness
l_q_=_b_=_l_word_manipulability	ity
r_q_=_b_=_l_word_manoeuvrability	ity
r_q_=_b_=_l_word_manufacturability	ity
p_q_=_b_=_l_word_mappability	ity
dzh_i_=_n_=_l_word_marginality	ity
m_a_=_s_i_v_word_massivity	ity
m_a_s_l_q_s_word_masslessness	ness
m_ay_=_t_y_=_word_mateyness	ness
l_q_=_b_=_l_word_matriculability	ity
l_oh_=_k_=_l_word_matrilocality	ity
s_i_=_m_=_l_word_maximality	ity
n_i_ng_f_ue_l_word_meaningfulness	ness
s_i_=_t_i_v_word_mechanosensitivity	ity
=_=_=_m_ee_=_word_meness	ness
t_q_=_m_i_kt_word_metamictness	ness
f_o_=_r_i_k_word_metaphoricity	ity
z_i_=_k_=_l_word_metaphysicality	ity
st_ay_=_b_=_l_word_metastability	ity
ky_oo_=_l_q_s_word_meticulousness	ness
z_q_=_b_=_l_word_metrizability	ity
st_q_=_l_eye_n_word_microcrystallinity	ity
p_or_=_r_q_s_word_microporosity	ity
s_eye_z_m_i_k_word_microseismicity	ity
t_oh_=_n_=_l_word_microtonality	ity
th_q_=_r_oh_d_phrase_middle-of-the-roadness	ness
=_=_=_m_eye_n_word_mineness	ness
n_i_=_m_=_l_word_minimality	ity
n_i_=_m_=_l_word_minimalness	ness
m_i_=_n_y_=_word_mininess	ness
m_i_n_t_y_=_word_mintiness	ness
r_e_k_t_i_d_word_misdirectedness	ness
dzh_e_=_n_i_k_word_mitogenicity	ity
s_q_=_b_=_l_word_mixability	ity
m_i_kst_=_u_p_word_mixed-upness	ness
m_o_=_b_i_sh_word_mobbishness	ness
z_q_=_b_=_l_word_mobilizability	ity
dy_oo_=_l_q_=_word_modularity	ity
m_oh_=_l_q_l_word_molality	ity
m_oh_=_l_q_=_word_molarity	ity
t_ay_=_n_i_=_word_momentaneity	ity
m_u_=_n_y_=_word_moneyness	ness
m_a_=_t_i_k_word_monochromaticity	ity
kl_oh_=_n_=_l_word_monoclonality	ity
dzh_ee_=_n_i_=_word_monogeneity	ity
dzh_e_=_n_i_k_word_monogenicity	ity
f_ay_=_z_i_k_word_monophasicity	ity
sh_oo_=_=_q_l_word_monosexuality	ity
s_i_=_f_i_k_word_monospecificity	ity
l_a_=_b_i_k_word_monosyllabicity	ity
t_oh_=_n_=_l_word_monotonality	ity
t_q_=_n_ay_=_word_monotoneity	ity
t_o_=_n_i_k_word_monotonicity	ity
z_eye_=_g_q_s_word_monozygosity	ity
=_=_=_m_oo_t_word_mootness	ness
m_oh_=_p_y_=_word_mopiness	ness
k_u_=_l_q_d_word_multicolouredness|multicoloredness	ness
sh_q_=_n_=_l_word_multidimensionality	ity
sh_=_n_n_=_l_word_multifunctionality	ity
l_ay_=_=_q_d_word_multilayeredness	ness
n_i_=_=_q_l_word_multilineality	ity
l_oh_=_k_=_l_word_multilocality	ity
ky_oo_=_l_q_r_word_multilocularity	ity
m_oh_=_d_=_l_word_multimodality	ity
t_i_=_pl_e_ks_word_multiplexity	ity
p_oh_=_l_q_=_word_multipolarity	ity
t_e_n_sh_=_l_word_multipotentiality	ity
m_q_=_b_=_l_word_multiprogrammability	ity
s_eye_=_d_i_d_word_multisidedness	ness
st_q_=_b_=_l_word_multistability	ity
v_oh_=_k_=_l_word_multivocality	ity
m_u_m_tsh_ah_ns_word_mumchanceness	ness
tsh_ah_n_s_y_=_word_mumchanciness	ness
m_u_m_z_y_=_word_mumsiness	ness
m_q_=_r_q_s_word_murmurousness	ness
m_ue_z_l_i_m_word_Muslimness	ness
dzh_ee_=_n_i_k_word_mutagenicity	ity
t_o_k_s_i_k_word_mycotoxicity	ity
t_o_k_s_i_k_word_myelinotoxicity	ity
l_e_k_tr_i_k_word_myoelectricity	ity
kr_i_=_=_q_s_word_nacreosity	ity
=_=_=_n_a_f_word_naffness	ness
n_a_=_n_i_=_word_nanniness	ness
n_a_=_p_i_=_word_nappiness	ness
r_q_=_t_i_v_word_narrativity	ity
dzh_q_=_b_=_l_word_negligibility	ity
n_ee_=_gr_oh_=_word_Negroness	ness
m_oh_=_d_=_l_word_neomodality	ity
t_o_k_s_i_k_word_nephrotoxicity	ity
n_ur_=_d_y_=_word_nerdiness	ness
n_ur_=_d_i_sh_word_nerdishness	ness
t_o_k_s_i_k_word_neurotoxicity	ity
l_a_=_d_i_sh_word_newladdishness	ness
n_eye_=_d_=_l_word_nidality	ity
n_i_=_p_y_=_word_nippiness	ness
w_i_=_t_i_d_word_nitwittedness	ness
n_o_=_b_y_=_word_nobbiness	ness
t_ur_=_n_=_l_word_nocturnality	ity
dy_oo_=_l_q_r_word_nodularity	ity
d_a_p_t_i_v_word_nonadaptiveness	ness
d_i_=_t_i_v_word_nonadditivity	ity
b_i_=_gy_oo_=_word_nonambiguity	ity
s_e_n_tr_=_l_word_non-centrality	ity
t_q_=_t_i_v_word_noncommutativity	ity
=_e_mp_t_y_=_word_non-emptiness	ness
m_q_=_b_=_l_word_nonflammability	ity
=_eye_=_d_iq_l_word_nonideality	ity
n_i_=_=_q_r_word_nonlinearity	ity
l_oh_=_k_=_l_word_nonlocality	ity
n_or_=_m_=_l_word_nonnormality	ity
v_i_=_=_q_s_word_nonobviousness	ness
t_q_=_b_=_l_word_nonorientability	ity
=_dzh_e_n_i_k_word_non-pathogenicity	ity
pl_ay_=_n_q_r_word_nonplanarity	ity
y_oo_=_n_ee_k_word_non-uniqueness	ness
n_oo_=_d_q_l_word_noodleness	ness
n_or_=_d_i_k_word_nordicity	ity
m_q_=_t_i_v_word_normativeness	ness
m_q_=_t_i_v_word_normativity	ity
n_or_m_l_q_s_word_normlessness	ness
=_=_=_n_or_s_word_norseness	ness
n_oh_=_z_y_=_word_nosiness	ness
n_o_=_tch_i_=_word_notchiness	ness
=_=_=_n_o_t_word_notness	ness
n_o_t_th_aq_=_phrase_notthereness	ness
n_ow_=_n_y_=_word_nouniness	ness
=_=_=_n_ow_n_word_nounness	ness
kl_i_=_=_q_r_word_nuclearity	ity
f_i_=_l_i_k_word_nucleophilicity	ity
=_=_=_n_u_l_word_nullness	ness
m_i_=_n_q_s_word_numinosity	ity
m_i_=_n_q_s_word_numinousness	ness
=_o_b_dzh_i_kt_word_objectness	ness
v_i_=_=_q_l_word_obliviality	ity
n_o_k_sh_q_s_word_obnoxity	ity
sh_q_=_n_=_l_word_observationality	ity
sh_=_n_n_=_l_word_obsessionality	ity
s_e_=_s_i_v_word_obsessiveness	ness
n_q_=_b_=_l_word_obtainability	ity
=_a_=_n_i_k_word_oceanicity	ity
=_oh_=_k_ay_=_word_OKness	ness
m_q_=_n_i_sh_word_oldwomanishness	ness
w_ur_ld_l_y_=_word_oldworldliness	ness
s_i_=_b_=_l_word_omissibility	ity
sh_=_n_n_=_l_word_omnidirectionality	ity
sh_oo_=_=_q_l_word_omnisexuality	ity
dzh_e_=_n_i_k_word_oncogenicity	ity
th_q_=_m_ay_k_phrase_onthemakeness	ness
=_e_n_d_i_d_word_openendedness	ness
t_e_ks_tsh_q_d_word_opentexturedness	ness
r_q_=_b_=_l_word_operability	ity
sh_q_=_n_=_l_word_operationality	ity
sh_=_n_n_=_l_word_oppositionality	ity
t_i_=_k_=_l_word_opticality	ity
t_i_=_m_=_l_word_optimality	ity
=_or_=_g_o_n_word_orgonity	ity
t_q_=_b_=_l_word_orientability	ity
r_q_=_t_u_nd_word_orotundity	ity
sky_oo_=_l_q_=_word_oscularity	ity
m_oh_=_l_q_l_word_osmolality	ity
m_oh_=_l_q_=_word_osmolarity	ity
g_yew_=_l_q_s_word_ostrobogulosity	ity
th_q_=_l_y_=_word_otherliness	ness
t_q_v_d_ay_t_phrase_outofdateness	ness
d_q_=_r_i_sh_word_outsiderishness	ness
d_q_=_l_y_=_word_outsiderliness	ness
s_eye_=_d_q_=_word_outsiderness	ness
b_ue_=_l_i_sh_word_overbullishness	ness
kr_ow_=_d_i_d_word_overcrowdedness	ness
dr_e_=_s_y_=_word_overdressiness	ness
t_e_k_t_i_v_word_overprotectiveness	ness
s_i_=_t_i_v_word_oversensitivity	ity
v_q_=_s_e_xt_word_oversexedness	ness
v_q_r_=_or_t_word_overwroughtness	ness
k_q_=_b_=_l_word_packability	ity
st_ay_=_k_i_ng_word_painstakingness	ness
t_q_=_b_=_l_word_paintabilty	ity
t_q_=_l_y_=_word_painterliness	ness
p_a_=_l_y_=_word_palliness	ness
z_q_=_b_=_l_word_paraphrasability	ity
f_oh_=_k_=_l_word_parfocality	ity
=_=_=_p_ah_t_word_partness	ness
p_ah_=_t_ee_=_word_partyness	ness
z_q_=_b_=_l_word_passivizability	ity
tr_i_=_=_q_l_word_patriality	ity
n_i_=_=_q_l_word_patrilineality	ity
l_oh_=_k_=_l_word_patrilocality	ity
p_ee_=_k_y_=_word_peakiness	ness
=_=_=_p_ee_=_word_peaness	ness
p_e_=_d_q_l_bound_pedality	ity
=_=_=_p_e_g_word_pegity	ity
t_q_=_b_=_l_bound_pelletability	ity
r_ay_=_n_ay_=_word_penecontemporaneity	ity
n_q_=_b_=_l_word_pensionability	ity
p_e_=_p_y_=_word_peppiness	ness
z_q_=_b_=_l_word_peptizability	ity
k_q_=_l_eye_n_word_peralkalinity	ity
m_q_=_b_=_l_word_performability	ity
m_q_=_t_i_v_word_performativity	ity
f_q_=_r_=_l_word_peripherality	ity
k_i_=_t_y_=_word_persnicketiness	ness
sp_e_k_t_i_v_word_perspectivity	ity
s_e_n_tr_i_k_word_phallocentricity	ity
n_ee_=_m_i_k_word_phonemicity	ity
f_oh_=_n_y_=_word_phoniness	ness
s_e_n_tr_i_k_word_phonocentricity	ity
=_a_k_t_i_v_word_photoactivity	ity
g_q_=_t_i_v_word_photonegativity	ity
=_o_=_d_i_k_word_photoperiodicity	ity
z_i_=_t_i_v_word_photopositivity	ity
s_q_=_b_=_l_word_photoreversibility	ity
t_o_k_s_i_k_word_phototoxicity	ity
dzh_e_=_n_i_k_word_phytopathogenicity	ity
k_q_=_y_oo_n_word_picayunity	ity
t_q_=_b_=_l_word_pivotability	ity
pl_u_=_m_y_=_word_plumminess	ness
t_e_n_sh_=_l_word_pluripotentiality	ity
=_=_=_pl_u_sh_word_plushness	ness
t_q_=_b_=_l_word_pocketability	ity
p_oh_=_l_i_sh_word_Polishness	ness
s_e_n_tr_i_k_word_polycentricity	ity
kl_oh_=_n_=_l_word_polyclonality	ity
d_i_=_sp_ur_s_word_polydispersity	ity
sh_q_=_n_=_l_word_polyfunctionality	ity
m_or_=_f_q_s_word_polymorphousness	ness
n_i_=_m_q_s_word_polyonymosity	ity
t_ee_=_m_i_k_word_polysystemicity	ity
t_oh_=_n_=_l_word_polytonality	ity
=_=_=_p_o_sh_word_poshness	ness
sh_q_=_n_=_l_word_positionality	ity
n_i_=_=_q_l_word_post-coloniality	ity
m_q_=_tsh_ooq_=_word_postmaturity	ity
m_o_=_d_ur_n_word_postmodernity	ity
p_o_=_t_y_=_word_pottiness	ness
k_o_n_sh_q_s_word_preconsciousness	ness
k_q_=_t_i_v_word_predicativity	ity
sh_q_ns_l_q_s_word_presciencelessness	ness
skr_i_p_t_i_v_word_prescriptivity	ity
z_e_n_t_i_d_word_presentedness	ness
=_a_k_t_i_v_word_proactivity	ity
s_e_p_t_i_v_word_proceptivity	ity
s_q_=_b_=_l_word_processability	ity
dzh_e_=_n_i_k_word_pyrogenicity	ity
p_i_=_d_=_l_word_quadrupedality	ity
kw_ee_=_r_i_ng_word_queeringness	ness
k_i_=_t_y_=_word_racketiness	ness
=_a_k_t_i_v_word_radioactivity	ity
m_i_=_n_q_s_word_radioluminosity	ity
d_i_=_=_q_s_bound_radiosity	ity
=_=_=_r_a_d_word_radness	ness
d_o_=_m_i_k_bound_randomicity	ity
dzh_q_=_b_=_l_word_rangeability	ity
tsh_q_=_b_=_l_word_reachability	ity
n_q_=_r_y_=_word_reactionariness	ness
r_iq_=_w_q_d_word_rearwardness	ness
s_e_=_s_i_v_word_recessivity	ity
k_ur_=_s_i_v_word_recursiveness	ness
k_ur_=_s_i_v_word_recursivity	ity
dzh_q_=_n_=_l_word_regionality	ity
s_q_=_b_=_l_word_reimbursability	ity
t_q_=_b_=_l_word_relatability	ity
r_q_=_b_=_l_word_repairableness	ness
t_q_=_b_=_l_word_repeatability	ity
t_q_=_b_=_l_word_reportability	ity
t_q_=_t_i_v_word_representativity	ity
w_or_=_d_i_ng_word_rewardingness	ness
r_ee_=_=_i_d_word_rheidity	ity
t_o_=_r_i_k_word_rhetoricity	ity
r_i_=_p_i_ng_word_rippingness	ness
r_oh_m_w_q_d_word_romewardness	ness
r_oo_t_s_y_=_word_rootsiness	ness
=_=_=_r_oh_z_word_roseness	ness
=_=_=_r_ow_zd_word_rousedness	ness
b_q_=_r_y_=_word_rubberiness	ness
b_ow_n_d_i_d_word_ruleboundedness	ness
n_q_=_b_=_l_word_runnability	ity
r_u_=_sh_q_n_word_russianness	ness
s_ay_=_kr_=_l_word_sacrality	ity
s_q_=_pr_oh_b_word_saprobity	ity
t_q_=_n_eye_n_word_saturninity	ity
sk_a_=_t_y_=_word_scattiness	ness
t_i_=_f_i_k_word_scientificity	ity
tsh_q_=_b_=_l_word_searchability	ity
z_q_=_n_=_l_word_seasonality	ity
h_a_n_d_i_d_word_second-handedness	ness
s_eye_z_m_i_k_word_seismicity	ity
l_e_k_t_i_v_word_selectivity	ity
s_e_k_s_y_=_word_sexiness	ness
m_q_=_r_y_=_word_shimmeriness	ness
k_q_=_b_=_l_word_shockability	ity
sl_u_=_sh_y_=_word_slushiness	ness
sn_eye_=_p_y_=_word_snipiness	ness
sn_oo_=_t_y_=_word_snootiness	ness
s_o_ng_l_q_s_word_songlessness	ness
sh_i_=_=_q_s_word_speciosity	ity
thr_i_f_t_y_=_word_spendthriftiness	ness
spl_a_=_sh_y_=_word_splashiness	ness
f_e_=_r_q_s_word_splendiferousness	ness
t_q_=_b_=_l_word_startability	ity
n_q_=_r_y_=_word_stationarity	ity
st_i_=_k_y_=_word_stickiness	ness
tsh_q_=_b_=_l_word_stretchability	ity
str_e_=_tsh_y_=_word_stretchiness	ness
str_eye_=_p_y_=_word_stripiness	ness
str_u_k_ty_q_d_word_structuredness	ness
=_=_=_st_u_k_word_stuckness	ness
d_i_=_t_i_v_word_subadditivity	ity
d_iq_=_r_i_=_word_subsidiarity	ity
ty_oo_=_t_i_v_word_substitutivity	ity
s_eye_=_d_=_l_word_suicidality	ity
m_q_=_b_=_l_word_summability	ity
d_u_k_t_i_v_word_superconductivity	ity
t_i_=_k_=_l_word_supercriticality	ity
fl_oo_=_=_i_d_word_superfluidity	ity
m_a_n_l_y_=_word_supermanliness	ness
t_q_=_t_i_=_word_supplementarity	ity
sw_a_ng_k_y_=_word_swankiness	ness
sw_oh_=_l_q_n_word_swollenness	ness
l_a_=_b_i_k_word_syllabicity	ity
kr_q_=_n_i_=_word_synchroneity	ity
kr_o_=_n_i_k_word_synchronicity	ity
m_a_=_t_i_k_word_systematicity	ity
t_a_=_k_y_=_word_tackiness	ness
t_a_k_t_i_k_word_tacticity	ity
t_e_k_n_i_k_word_technicity	ity
str_i_=_=_q_l_word_terrestriality	ity
f_eye_=_=_i_ng_word_terrifyingness	ness
st_q_=_b_=_l_word_testability	ity
k_q_=_b_=_l_word_trackability	ity
n_q_=_b_=_l_word_trainability	ity
m_i_=_s_i_v_word_transmissivitiy	ity
t_q_=_b_=_l_word_treatability	ity
tr_ee_=_=_y_=_word_treeiness	ness
tr_e_n_d_y_=_word_trendiness	ness
p_i_=_k_=_l_word_tropicality	ity
n_q_=_b_=_l_word_tunability	ity
p_i_=_k_q_l_bound_typicity	ity
y_oo_=_b_i_k_bound_ubicity	ity
b_i_=_z_i_=_word_unbusiness	ness
v_q_=_k_=_l_word_univocality	ity
tsh_q_=_b_=_l_word_untouchability	ity
p_q_=_kl_ah_s_phrase_upperclassness	ness
r_oo_=_t_i_d_word_uprootedness	ness
s_e_=_t_i_ng_word_upsettingness	ness
=_=_=_=_u_s_word_usness	ness
r_i_=_d_i_k_bound_veridicity	ity
ky_oo_=_l_q_=_word_vesicularity	ity
w_or_=_l_q_s_word_warlessness	ness
t_q_=_pr_oo_f_word_waterproofness	ness
r_q_=_b_=_l_word_wearability	ity
=_=_=_w_ee_=_word_weness	ness
=_=_=_w_e_ns_word_whenceness	ness
=_=_=_h_oo_=_word_whoness	ness
n_q_=_b_=_l_word_winnability	ity
w_i_th_dr_o_n_word_withdrawnness	ness
=_=_=_w_i_th_word_withness	ness
k_i_ng_kl_ah_s_phrase_workingclassness	ness
z_eye_=_g_oh_s_bound_zygosity	ity
