Cues	Outcomes
q_b_ow_t_word_aboutness	ness
v_q_b_l_word_achievability	ity
sh_n_n_q_l_word_additionality	ity
d_i_t_i_v_word_additivity	ity
s_q_b_l_word_addressability	ity
b_q_b_l_word_adsorbability	ity
z_or_p_t_i_v_word_adsorptivity	ity
l_a_st_i_k_word_aeroelasticity	ity
f_e_kt_l_q_s_word_affectlessness	ness
d_q_b_l_word_affordability	ity
fr_i_k_q_n_word_Africanity	ity
q_g_e_nst_word_againstness	ness
dzh_q_n_t_i_v_word_agentivity	ity
g_q_b_l_word_aggregability	ity
gr_e_s_i_v_word_aggressivity	ity
w_ur_th_y_word_airworthiness	ness
l_i_q_n_word_alienness	ness
dzh_e_n_i_k_word_allergenicity	ity
i_my_oo_n_word_alloimmunity	ity
dzh_i_k_l_word_alogicality	ity
z_q_b_l_word_analysability	ity
l_i_t_i_k_word_analyticity	ity
r_q_b_l_word_answerability	ity
r_i_q_l_word_arboreality	ity
a_r_bound_arity	ity
m_a_t_i_k_word_aromaticity	ity
ay_zh_q_n_word_Asianness	ness
a_z_s_u_tsh_phrase_as-suchness	ness
l_i_q_n_word_Australianness	ness
v_q_r_i_dzh_word_averageness	ness
w_ay_k_i_d_word_awakedness	ness
r_q_b_l_word_bearability	ity
b_i_y_o_nd_word_beyondness	ness
by_u_l_q_s_word_bibulosity	ity
d_q_b_l_word_biddability	ity
l_i_ng_gw_l_word_bilinguality	ity
m_oh_d_l_word_bimodality	ity
d_q_b_l_word_biodegradability	ity
l_e_k_tr_i_k_word_bioelectricity	ity
dzh_e_n_i_k_word_biogenicity	ity
t_oh_n_l_word_bitonality	ity
bl_oh_k_i_sh_word_blokeishness	ness
bl_ur_r_y_word_blurriness	ness
b_oh_g_q_s_word_bogusness	ness
th_q_b_l_word_breathability	ity
b_u_l_b_q_s_word_bulbosity	ity
k_a_t_y_word_cattiness	ness
fy_oo_g_l_word_centrifugality	ity
s_i_t_i_v_word_chemosensitivity	ity
kl_or_r_i_n_word_chlorinity	ity
kl_ah_s_l_q_s_word_classlessness	ness
kl_oh_n_l_word_clonality	ity
b_q_b_l_word_clubbableness	ness
d_q_b_l_word_codability	ity
g_q_b_l_word_colligability	ity
k_q_b_l_word_collocability	ity
b_q_t_i_v_word_combativity	ity
t_ay_t_i_v_word_commutativeness	ness
t_q_t_i_v_word_commutativity	ity
t_q_t_i_word_complementarity	ity
p_u_l_s_i_v_word_compulsiveness	ness
r_q_d_l_y_word_comradeliness	ness
m_q_b_l_word_confirmability	ity
l_q_b_l_word_congealability	ity
dzh_u_ngk_t_i_v_word_conjunctiveness	ness
t_q_b_l_word_connectibility	ity
m_i_n_q_s_word_conterminousness	ness
l_q_b_l_word_controllability	ity
k_or_n_y_word_corniness	ness
kr_a_k_i_d_word_crackedness	ness
w_ur_th_y_word_crashworthiness	ness
k_u_p_y_word_cuppiness	ness
t_o_k_s_i_k_word_cytotoxicity	ity
d_a_b_word_dabbity	ity
d_a_sh_i_ng_word_dashingness	ness
d_ay_t_i_d_word_datedness	ness
d_e_f_bl_eye_nd_word_deafblindness	ness
d_q_b_l_word_decidability	ity
m_ah_n_dr_i_ng_word_demandingness	ness
r_q_b_l_word_denumerability	ity
d_q_b_l_word_dependability	ity
pr_e_s_i_ng_word_depressingness	ness
str_u_k_t_i_v_word_destructivity	ity
q_b_l_word_deviability	ity
sh_iq_b_l_word_differentiability	ity
r_e_k_t_i_d_word_directedness	ness
sh_q_n_l_word_directionality	ity
r_e_k_t_i_v_word_directivity	ity
n_q_b_l_word_discriminability	ity
k_ur_s_i_v_word_discursivity	ity
p_ur_s_i_v_word_dispersivity	ity
t_q_b_l_word_distractability	ity
by_u_t_i_v_word_distributivity	ity
d_u_n_word_doneness	ness
d_oh_p_y_word_dopiness	ness
e_dzh_i_d_word_double-edgedness	ness
dr_ee_m_l_q_s_word_dreamlessness	ness
dr_eye_d_word_driedness	ness
v_q_b_l_word_driveability	ity
sh_q_n_l_word_dysfunctionality	ity
t_o_k_s_i_k_word_ecotoxicity	ity
ny_oo_tr_l_word_electroneutrality	ity
f_i_l_i_k_word_electrophilicity	ity
n_q_b_l_word_eliminability	ity
q_b_l_word_employability	ity
s_q_b_l_word_enforceability	ity
r_q_b_l_word_enumerability	ity
q_b_l_word_enviability	ity
s_o_d_i_k_word_episodicity	ity
b_q_b_l_word_equiprobability	ity
t_q_b_l_word_equitability	ity
p_ee_q_n_word_Europeanness	ness
v_q_b_l_word_evolvability	ity
s_eye_t_i_ng_word_excitingness	ness
k_l_oo_s_i_v_word_exclusivity	ity
d_q_b_l_word_expandability	ity
t_q_b_l_word_exploitability	ity
pr_e_s_i_v_word_expressivity	ity
zh_q_n_l_word_extensionality	ity
f_a_k_t_i_k_word_facticity	ity
ty_oo_q_l_word_factualness	ness
q_b_l_word_falsifiability	ity
f_a_n_s_y_word_fanciness	ness
g_q_b_l_word_fatigability	ity
l_e_k_tr_i_k_word_ferroelectricity	ity
r_q_b_l_word_filterability	ity
h_a_n_d_i_d_word_firsthandedness	ness
g_o_t_q_n_word_forgottenness	ness
fr_i_z_y_word_frizziness	ness
fr_u_n_t_l_word_frontality	ity
fr_ow_st_y_word_frowstiness	ness
fr_u_m_p_y_word_frumpiness	ness
k_q_b_l_word_fuckability	ity
g_a_b_y_word_gabbiness	ness
g_ee_k_y_word_geekiness	ness
g_ee_k_i_sh_word_geekishness	ness
z_q_b_l_word_generalizability	ity
r_q_t_i_v_word_generativity	ity
n_e_r_i_k_word_genericity	ity
n_e_r_i_k_word_genericness	ness
g_ow_l_i_sh_word_ghoulishness	ness
gl_oh_b_l_word_globality	ity
g_oo_f_y_word_goofiness	ness
d_q_b_l_word_gradability	ity
d_q_b_l_word_gradeability	ity
gr_ay_n_y_word_graininess	ness
t_i_k_l_word_grammaticality	ity
d_q_b_l_word_grindability	ity
g_u_st_y_word_gustiness	ness
h_a_n_d_i_d_word_handedness	ness
l_q_b_l_word_handleability	ity
q_nd_f_ah_st_phrase_hard-and-fastness	ness
n_q_b_l_word_hardenability	ity
h_ee_l_i_k_bound_helicity	ity
m_q_t_i_v_word_heteronormativity	ity
t_i_b_l_word_histocompatibility	ity
h_ur_t_word_hurtness	ness
s_i_t_i_v_word_hypersensitivity	ity
t_o_n_i_k_word_hypotonicity	ity
k_o_n_i_k_word_iconicity	ity
a_k_t_i_v_word_immunoreactivity	ity
p_e_l_i_ng_word_impellingness	ness
t_i_k_l_word_impracticality	ity
s_e_n_d_i_v_word_incendivity	ity
kl_oo_s_i_v_word_inclusivity	ity
kw_e_n_sh_l_word_inconsequentialness	ness
n_q_b_l_word_indefinability	ity
s_q_b_l_word_inducibility	ity
k_q_b_l_word_ineducability	ity
i_i_k_l_word_inepticality	ity
r_i_b_l_word_inferrability	ity
m_q_t_i_v_word_informativeness	ness
i_t_s_e_lf_phrase_in-itselfness	ness
s_eye_d_ow_t_phrase_inside-outness	ness
zh_q_n_l_word_intensionality	ity
n_e_k_t_i_d_word_interconnectedness	ness
l_q_b_l_word_interpolability	ity
t_q_t_i_v_word_interpretativeness	ness
sy_oo_l_word_intersexuality	ity
s_q_b_l_word_intransmissibility	ity
v_ay_z_i_v_word_invasiveness	ness
o_n_i_k_word_ionicity	ity
sh_q_n_l_word_irrotationality	ity
p_q_n_ee_z_word_Japaneseness	ness
dzh_o_b_l_q_s_word_joblessness	ness
k_i_ng_k_y_word_kinkiness	ness
t_q_n_i_sh_word_kittenishness	ness
kl_e_n_dy_oo_s_bound_klendusity	ity
n_o_t_i_d_word_knottedness	ness
l_ay_s_y_word_laciness	ness
l_ay_i_k_word_laicity	ity
n_q_b_l_word_learnability	ity
l_e_ft_w_q_d_word_leftwardness	ness
l_e_g_l_q_s_word_leglessness	ness
ky_oo_l_q_word_lenticularity	ity
m_i_n_l_word_liminality	ity
l_eye_m_y_word_liminess	ness
l_i_ng_k_i_d_word_linkedness	ness
d_q_b_l_word_loadability	ity
z_q_b_l_word_localizability	ity
l_o_g_y_word_logginess	ness
l_o_p_y_word_loppiness	ness
l_ur_k_i_ng_word_lurkingness	ness
n_q_b_l_word_machinability	ity
t_q_l_eye_n_word_macrocrystallinity	ity
n_q_b_l_word_maintainability	ity
m_or_l_t_y_word_maltiness	ness
l_q_b_l_word_manipulability	ity
r_q_b_l_word_manoeuvrability	ity
r_q_b_l_word_manufacturability	ity
p_q_b_l_word_mappability	ity
dzh_i_n_l_word_marginality	ity
m_a_s_i_v_word_massivity	ity
m_a_s_l_q_s_word_masslessness	ness
m_ay_t_y_word_mateyness	ness
l_q_b_l_word_matriculability	ity
l_oh_k_l_word_matrilocality	ity
s_i_m_l_word_maximality	ity
n_i_ng_f_ue_l_word_meaningfulness	ness
s_i_t_i_v_word_mechanosensitivity	ity
m_ee_word_meness	ness
t_q_m_i_kt_word_metamictness	ness
f_o_r_i_k_word_metaphoricity	ity
z_i_k_l_word_metaphysicality	ity
st_ay_b_l_word_metastability	ity
ky_oo_l_q_s_word_meticulousness	ness
z_q_b_l_word_metrizability	ity
st_q_l_eye_n_word_microcrystallinity	ity
p_or_r_q_s_word_microporosity	ity
s_eye_z_m_i_k_word_microseismicity	ity
t_oh_n_l_word_microtonality	ity
th_q_r_oh_d_phrase_middle-of-the-roadness	ness
m_eye_n_word_mineness	ness
n_i_m_l_word_minimality	ity
n_i_m_l_word_minimalness	ness
m_i_n_y_word_mininess	ness
m_i_n_t_y_word_mintiness	ness
r_e_k_t_i_d_word_misdirectedness	ness
dzh_e_n_i_k_word_mitogenicity	ity
s_q_b_l_word_mixability	ity
m_i_kst_u_p_word_mixed-upness	ness
m_o_b_i_sh_word_mobbishness	ness
z_q_b_l_word_mobilizability	ity
dy_oo_l_q_word_modularity	ity
m_oh_l_q_l_word_molality	ity
m_oh_l_q_word_molarity	ity
t_ay_n_i_word_momentaneity	ity
m_u_n_y_word_moneyness	ness
m_a_t_i_k_word_monochromaticity	ity
kl_oh_n_l_word_monoclonality	ity
dzh_ee_n_i_word_monogeneity	ity
dzh_e_n_i_k_word_monogenicity	ity
f_ay_z_i_k_word_monophasicity	ity
sh_oo_q_l_word_monosexuality	ity
s_i_f_i_k_word_monospecificity	ity
l_a_b_i_k_word_monosyllabicity	ity
t_oh_n_l_word_monotonality	ity
t_q_n_ay_word_monotoneity	ity
t_o_n_i_k_word_monotonicity	ity
z_eye_g_q_s_word_monozygosity	ity
m_oo_t_word_mootness	ness
m_oh_p_y_word_mopiness	ness
k_u_l_q_d_word_multicolouredness|multicoloredness	ness
sh_q_n_l_word_multidimensionality	ity
sh_n_n_l_word_multifunctionality	ity
l_ay_q_d_word_multilayeredness	ness
n_i_q_l_word_multilineality	ity
l_oh_k_l_word_multilocality	ity
ky_oo_l_q_r_word_multilocularity	ity
m_oh_d_l_word_multimodality	ity
t_i_pl_e_ks_word_multiplexity	ity
p_oh_l_q_word_multipolarity	ity
t_e_n_sh_l_word_multipotentiality	ity
m_q_b_l_word_multiprogrammability	ity
s_eye_d_i_d_word_multisidedness	ness
st_q_b_l_word_multistability	ity
v_oh_k_l_word_multivocality	ity
m_u_m_tsh_ah_ns_word_mumchanceness	ness
tsh_ah_n_s_y_word_mumchanciness	ness
m_u_m_z_y_word_mumsiness	ness
m_q_r_q_s_word_murmurousness	ness
m_ue_z_l_i_m_word_Muslimness	ness
dzh_ee_n_i_k_word_mutagenicity	ity
t_o_k_s_i_k_word_mycotoxicity	ity
t_o_k_s_i_k_word_myelinotoxicity	ity
l_e_k_tr_i_k_word_myoelectricity	ity
kr_i_q_s_word_nacreosity	ity
n_a_f_word_naffness	ness
n_a_n_i_word_nanniness	ness
n_a_p_i_word_nappiness	ness
r_q_t_i_v_word_narrativity	ity
dzh_q_b_l_word_negligibility	ity
n_ee_gr_oh_word_Negroness	ness
m_oh_d_l_word_neomodality	ity
t_o_k_s_i_k_word_nephrotoxicity	ity
n_ur_d_y_word_nerdiness	ness
n_ur_d_i_sh_word_nerdishness	ness
t_o_k_s_i_k_word_neurotoxicity	ity
l_a_d_i_sh_word_newladdishness	ness
n_eye_d_l_word_nidality	ity
n_i_p_y_word_nippiness	ness
w_i_t_i_d_word_nitwittedness	ness
n_o_b_y_word_nobbiness	ness
t_ur_n_l_word_nocturnality	ity
dy_oo_l_q_r_word_nodularity	ity
d_a_p_t_i_v_word_nonadaptiveness	ness
d_i_t_i_v_word_nonadditivity	ity
b_i_gy_oo_word_nonambiguity	ity
s_e_n_tr_l_word_non-centrality	ity
t_q_t_i_v_word_noncommutativity	ity
e_mp_t_y_word_non-emptiness	ness
m_q_b_l_word_nonflammability	ity
eye_d_iq_l_word_nonideality	ity
n_i_q_r_word_nonlinearity	ity
l_oh_k_l_word_nonlocality	ity
n_or_m_l_word_nonnormality	ity
v_i_q_s_word_nonobviousness	ness
t_q_b_l_word_nonorientability	ity
dzh_e_n_i_k_word_non-pathogenicity	ity
pl_ay_n_q_r_word_nonplanarity	ity
y_oo_n_ee_k_word_non-uniqueness	ness
n_oo_d_q_l_word_noodleness	ness
n_or_d_i_k_word_nordicity	ity
m_q_t_i_v_word_normativeness	ness
m_q_t_i_v_word_normativity	ity
n_or_m_l_q_s_word_normlessness	ness
n_or_s_word_norseness	ness
n_oh_z_y_word_nosiness	ness
n_o_tch_i_word_notchiness	ness
n_o_t_word_notness	ness
n_o_t_th_aq_phrase_notthereness	ness
n_ow_n_y_word_nouniness	ness
n_ow_n_word_nounness	ness
kl_i_q_r_word_nuclearity	ity
f_i_l_i_k_word_nucleophilicity	ity
n_u_l_word_nullness	ness
m_i_n_q_s_word_numinosity	ity
m_i_n_q_s_word_numinousness	ness
o_b_dzh_i_kt_word_objectness	ness
v_i_q_l_word_obliviality	ity
n_o_k_sh_q_s_word_obnoxity	ity
sh_q_n_l_word_observationality	ity
sh_n_n_l_word_obsessionality	ity
s_e_s_i_v_word_obsessiveness	ness
n_q_b_l_word_obtainability	ity
a_n_i_k_word_oceanicity	ity
oh_k_ay_word_OKness	ness
m_q_n_i_sh_word_oldwomanishness	ness
w_ur_ld_l_y_word_oldworldliness	ness
s_i_b_l_word_omissibility	ity
sh_n_n_l_word_omnidirectionality	ity
sh_oo_q_l_word_omnisexuality	ity
dzh_e_n_i_k_word_oncogenicity	ity
th_q_m_ay_k_phrase_onthemakeness	ness
e_n_d_i_d_word_openendedness	ness
t_e_ks_tsh_q_d_word_opentexturedness	ness
r_q_b_l_word_operability	ity
sh_q_n_l_word_operationality	ity
sh_n_n_l_word_oppositionality	ity
t_i_k_l_word_opticality	ity
t_i_m_l_word_optimality	ity
or_g_o_n_word_orgonity	ity
t_q_b_l_word_orientability	ity
r_q_t_u_nd_word_orotundity	ity
sky_oo_l_q_word_oscularity	ity
m_oh_l_q_l_word_osmolality	ity
m_oh_l_q_word_osmolarity	ity
g_yew_l_q_s_word_ostrobogulosity	ity
th_q_l_y_word_otherliness	ness
t_q_v_d_ay_t_phrase_outofdateness	ness
d_q_r_i_sh_word_outsiderishness	ness
d_q_l_y_word_outsiderliness	ness
s_eye_d_q_word_outsiderness	ness
b_ue_l_i_sh_word_overbullishness	ness
kr_ow_d_i_d_word_overcrowdedness	ness
dr_e_s_y_word_overdressiness	ness
t_e_k_t_i_v_word_overprotectiveness	ness
s_i_t_i_v_word_oversensitivity	ity
v_q_s_e_xt_word_oversexedness	ness
v_q_r_or_t_word_overwroughtness	ness
k_q_b_l_word_packability	ity
st_ay_k_i_ng_word_painstakingness	ness
t_q_b_l_word_paintabilty	ity
t_q_l_y_word_painterliness	ness
p_a_l_y_word_palliness	ness
z_q_b_l_word_paraphrasability	ity
f_oh_k_l_word_parfocality	ity
p_ah_t_word_partness	ness
p_ah_t_ee_word_partyness	ness
z_q_b_l_word_passivizability	ity
tr_i_q_l_word_patriality	ity
n_i_q_l_word_patrilineality	ity
l_oh_k_l_word_patrilocality	ity
p_ee_k_y_word_peakiness	ness
p_ee_word_peaness	ness
p_e_d_q_l_bound_pedality	ity
p_e_g_word_pegity	ity
t_q_b_l_bound_pelletability	ity
r_ay_n_ay_word_penecontemporaneity	ity
n_q_b_l_word_pensionability	ity
p_e_p_y_word_peppiness	ness
z_q_b_l_word_peptizability	ity
k_q_l_eye_n_word_peralkalinity	ity
m_q_b_l_word_performability	ity
m_q_t_i_v_word_performativity	ity
f_q_r_l_word_peripherality	ity
k_i_t_y_word_persnicketiness	ness
sp_e_k_t_i_v_word_perspectivity	ity
s_e_n_tr_i_k_word_phallocentricity	ity
n_ee_m_i_k_word_phonemicity	ity
f_oh_n_y_word_phoniness	ness
s_e_n_tr_i_k_word_phonocentricity	ity
a_k_t_i_v_word_photoactivity	ity
g_q_t_i_v_word_photonegativity	ity
o_d_i_k_word_photoperiodicity	ity
z_i_t_i_v_word_photopositivity	ity
s_q_b_l_word_photoreversibility	ity
t_o_k_s_i_k_word_phototoxicity	ity
dzh_e_n_i_k_word_phytopathogenicity	ity
k_q_y_oo_n_word_picayunity	ity
t_q_b_l_word_pivotability	ity
pl_u_m_y_word_plumminess	ness
t_e_n_sh_l_word_pluripotentiality	ity
pl_u_sh_word_plushness	ness
t_q_b_l_word_pocketability	ity
p_oh_l_i_sh_word_Polishness	ness
s_e_n_tr_i_k_word_polycentricity	ity
kl_oh_n_l_word_polyclonality	ity
d_i_sp_ur_s_word_polydispersity	ity
sh_q_n_l_word_polyfunctionality	ity
m_or_f_q_s_word_polymorphousness	ness
n_i_m_q_s_word_polyonymosity	ity
t_ee_m_i_k_word_polysystemicity	ity
t_oh_n_l_word_polytonality	ity
p_o_sh_word_poshness	ness
sh_q_n_l_word_positionality	ity
n_i_q_l_word_post-coloniality	ity
m_q_tsh_ooq_word_postmaturity	ity
m_o_d_ur_n_word_postmodernity	ity
p_o_t_y_word_pottiness	ness
k_o_n_sh_q_s_word_preconsciousness	ness
k_q_t_i_v_word_predicativity	ity
sh_q_ns_l_q_s_word_presciencelessness	ness
skr_i_p_t_i_v_word_prescriptivity	ity
z_e_n_t_i_d_word_presentedness	ness
a_k_t_i_v_word_proactivity	ity
s_e_p_t_i_v_word_proceptivity	ity
s_q_b_l_word_processability	ity
dzh_e_n_i_k_word_pyrogenicity	ity
p_i_d_l_word_quadrupedality	ity
kw_ee_r_i_ng_word_queeringness	ness
k_i_t_y_word_racketiness	ness
a_k_t_i_v_word_radioactivity	ity
m_i_n_q_s_word_radioluminosity	ity
d_i_q_s_bound_radiosity	ity
r_a_d_word_radness	ness
d_o_m_i_k_bound_randomicity	ity
dzh_q_b_l_word_rangeability	ity
tsh_q_b_l_word_reachability	ity
n_q_r_y_word_reactionariness	ness
r_iq_w_q_d_word_rearwardness	ness
s_e_s_i_v_word_recessivity	ity
k_ur_s_i_v_word_recursiveness	ness
k_ur_s_i_v_word_recursivity	ity
dzh_q_n_l_word_regionality	ity
s_q_b_l_word_reimbursability	ity
t_q_b_l_word_relatability	ity
r_q_b_l_word_repairableness	ness
t_q_b_l_word_repeatability	ity
t_q_b_l_word_reportability	ity
t_q_t_i_v_word_representativity	ity
w_or_d_i_ng_word_rewardingness	ness
r_ee_i_d_word_rheidity	ity
t_o_r_i_k_word_rhetoricity	ity
r_i_p_i_ng_word_rippingness	ness
r_oh_m_w_q_d_word_romewardness	ness
r_oo_t_s_y_word_rootsiness	ness
r_oh_z_word_roseness	ness
r_ow_zd_word_rousedness	ness
b_q_r_y_word_rubberiness	ness
b_ow_n_d_i_d_word_ruleboundedness	ness
n_q_b_l_word_runnability	ity
r_u_sh_q_n_word_russianness	ness
s_ay_kr_l_word_sacrality	ity
s_q_pr_oh_b_word_saprobity	ity
t_q_n_eye_n_word_saturninity	ity
sk_a_t_y_word_scattiness	ness
t_i_f_i_k_word_scientificity	ity
tsh_q_b_l_word_searchability	ity
z_q_n_l_word_seasonality	ity
h_a_n_d_i_d_word_second-handedness	ness
s_eye_z_m_i_k_word_seismicity	ity
l_e_k_t_i_v_word_selectivity	ity
s_e_k_s_y_word_sexiness	ness
m_q_r_y_word_shimmeriness	ness
k_q_b_l_word_shockability	ity
sl_u_sh_y_word_slushiness	ness
sn_eye_p_y_word_snipiness	ness
sn_oo_t_y_word_snootiness	ness
s_o_ng_l_q_s_word_songlessness	ness
sh_i_q_s_word_speciosity	ity
thr_i_f_t_y_word_spendthriftiness	ness
spl_a_sh_y_word_splashiness	ness
f_e_r_q_s_word_splendiferousness	ness
t_q_b_l_word_startability	ity
n_q_r_y_word_stationarity	ity
st_i_k_y_word_stickiness	ness
tsh_q_b_l_word_stretchability	ity
str_e_tsh_y_word_stretchiness	ness
str_eye_p_y_word_stripiness	ness
str_u_k_ty_q_d_word_structuredness	ness
st_u_k_word_stuckness	ness
d_i_t_i_v_word_subadditivity	ity
d_iq_r_i_word_subsidiarity	ity
ty_oo_t_i_v_word_substitutivity	ity
s_eye_d_l_word_suicidality	ity
m_q_b_l_word_summability	ity
d_u_k_t_i_v_word_superconductivity	ity
t_i_k_l_word_supercriticality	ity
fl_oo_i_d_word_superfluidity	ity
m_a_n_l_y_word_supermanliness	ness
t_q_t_i_word_supplementarity	ity
sw_a_ng_k_y_word_swankiness	ness
sw_oh_l_q_n_word_swollenness	ness
l_a_b_i_k_word_syllabicity	ity
kr_q_n_i_word_synchroneity	ity
kr_o_n_i_k_word_synchronicity	ity
m_a_t_i_k_word_systematicity	ity
t_a_k_y_word_tackiness	ness
t_a_k_t_i_k_word_tacticity	ity
t_e_k_n_i_k_word_technicity	ity
str_i_q_l_word_terrestriality	ity
f_eye_i_ng_word_terrifyingness	ness
st_q_b_l_word_testability	ity
k_q_b_l_word_trackability	ity
n_q_b_l_word_trainability	ity
m_i_s_i_v_word_transmissivitiy	ity
t_q_b_l_word_treatability	ity
tr_ee_y_word_treeiness	ness
tr_e_n_d_y_word_trendiness	ness
p_i_k_l_word_tropicality	ity
n_q_b_l_word_tunability	ity
p_i_k_q_l_bound_typicity	ity
y_oo_b_i_k_bound_ubicity	ity
b_i_z_i_word_unbusiness	ness
v_q_k_l_word_univocality	ity
tsh_q_b_l_word_untouchability	ity
p_q_kl_ah_s_phrase_upperclassness	ness
r_oo_t_i_d_word_uprootedness	ness
s_e_t_i_ng_word_upsettingness	ness
u_s_word_usness	ness
r_i_d_i_k_bound_veridicity	ity
ky_oo_l_q_word_vesicularity	ity
w_or_l_q_s_word_warlessness	ness
t_q_pr_oo_f_word_waterproofness	ness
r_q_b_l_word_wearability	ity
w_ee_word_weness	ness
w_e_ns_word_whenceness	ness
h_oo_word_whoness	ness
n_q_b_l_word_winnability	ity
w_i_th_dr_o_n_word_withdrawnness	ness
w_i_th_word_withness	ness
k_i_ng_kl_ah_s_phrase_workingclassness	ness
z_eye_g_oh_s_bound_zygosity	ity
